########
#......# 
#.####.#
#......# 
#.####.#
#......#
########